NO Imgs/NO-img.xpm
SO  Imgs/SO-img.xpm
WE  Imgs/WE-img.xpm
EA  Imgs/EA-img.xpm

F 0,51,0
C 153,204,229

1111111111111111111111
1000000000000100000001
1000000000000100000001
1000000000000100000001
1000S00000000111000001
1000000000000000000011
1000000000000000000011
1000000000000000000011
1111111111111111111111
